XXXXXXXXXXXXXXXXXXXXXXXXXXXXX
X...........X.....X...X.....X
X...X.....X.X.XXX.X.XXX.X.XXX
X.........X...X...X...X.X....
XX......X.XXXXX.XXXXX.X.XXXXX
X.......X...X...X.....X.....X
X.......XXX.X.XXX.XXX.XXXXX.X
X.........X.X.....X...X...X.X
X.......XXX.XXXXXXX.XXXXX.X.X
X.......X...X...X.........X.X
XX......X.XXX.X.XXXXXXXXXXX.X
X...X...X.....X.X.........X.X
X...X.X.XXXXXXX.X.XXXXXXX.X.X
X.............X.........X...X
XXXXXXXXXXXXXXXXXXXXXXX.XXXXX
